1111101111111111111111111111111111111111111111111111111111111111111111111111111111111111111111111111
1011100101110111100000001100011111000000001010000110000000000000000000001110000000000000000000000001
1000001100110101001110100101000000011111011110110010111111011101100111111000111111001111111111111001
1101101110000101100010110101011111001001000110111000000111011101110011110011101111100110001000111001
1100100111110100101010010101011001100001010010101011010011111111111111100110000000110011011110011101
1101110000110101111010110101001101001101011011101011011000000000000000001110101110011011001010000101
1001011110010100000011110101100100000100011001101001111101111110111101111000101110111001011010110101
1101000011000110101001110100110110010101011101101100111111111110111111111111101000011100011000110101
1101011001110011101111000110010011010101000101101110011000011110000000000000001110111101111010110101
1101001100111000111011010011111001000101010101101111000011000011111111110111011110111101100010100101
1001101110101110011000010000111001101101010101100011101111111000111101110111010000000100101110111101
1100100010001111001111011110000011101001010100111011001000001110011101110111011110111110100000000101
1110111110100001100011000011111110101011010110010010011111101111001101111111111110101100111111110101
1110000000111100101001111000000000001011010110010010111100000000001100000000110000101110100000000101
1111111011100110101100011111111111011000010010111000111001111111100111111110111110000110101111110111
1100001010000010101101000000000011011111111000111001100011000000110110000000111110110110101011110111
1001111010111010101001111101101000000000000000000011111001011110010010111110000010110110101010000101
1100000010011011101011000101101101101111111111111111111101011111011011111110110110111110101011110001
1111111011011000000001010101101101101000000000000000000100000101011000000110110110011100101011110001
1110000001001101010011110101101101101011011111111111110101110101011011110110110110000110100001100101
1000111100001111111000000100101100101011111111111111110101110100011010110110111100111110101111001101
1010010111101000111111111100100101101010000000000000010101110111110000010110000001111100101110011101
1011000101101010001000000001101100111011101101011111010101110111000111010111111100111001101100110001
1011111100101011101111110011101100111011101101000011010101110000011111010100111110111011111001110101
1000000001101010101111110110100101100000101101011111000000000111011000010110110111100011110011010101
1111111111101010101000000110111101101010101101011100011101111111001101010110110110001111110111010101
1000001000101010101011111110111101101010101101110001111000111111100101010110110100111111100101011101
1010100011101010101010000000000000001010101101100111000010000000110101000110100001111111001100000101
1011101000101010101010101011111111111011101101001111011111111110000101111100001101111100011110110001
1000101101101010100010101011111000001000001101011000010000000011110000000001011101110001111010111101
1010101001101010101010101011000011111011101101011011000111101001111111011101000111100111001010101101
1010101100101010101010111011011111111111001100011011010111101100001111011101110110001101101010100101
1010101111101010101010000011011100000011011111001001010000101111100001011100110000111000000000101101
1000100001001010001011111010000001111011011001101101011110000011111100001110000111111111111111100001
1010110101011011111011111011111111111011001101101101000011111000111111100000011111000000000011111101
1010110111010000000000000001110001111011011101100111011000001110000111111101011011011111101011101101
1010110001010111111111111101110101011011010101110001111101100010110000011101011011011001101001001101
1010111111010000000000001101110101011011010100011100001101001000111111000101001000001101101101011101
1010000000010111111111101101110101011011010101001111100111111010000011110001101011100101101101011101
1011110111010111110000100101110101011011010101100011110001111010101000011000100011110101101101001101
1000010111010100000110110100110101011010010111101000011100001011101101001110001111110101101101101101
1011010001010111110111010110010101000010110000001111001111100001111001100110111111000101001100101101
1011111111010111110001010110000101011110111111111111101101111100011111000010110000011101111110000101
1000000001010000010011010110111101011110100000000000000001111111000001101000000111110000000000011101
1111111111011111010011010110100000000000101111111111011111100001011101111011111111111111111111011101
1000001101010001010000010110101111011110100000000000000000001100010101111010000000000000000001001101
1011101000011011010111110110111111111110111111111111111111111111010101000010111111111111111101100101
1010111101011011010000000110000000000000000000000000000000000000010101011110110000000000000000110001
1000000001000000011111101111101111111111101111111111111011111111110001000000110111111111111111111001
1111111111111111111111111111111111111111111111111111111111111111111111011111111111111111111111111111