11111111111111111111111111111111111111111111111111
11001000000100110000000000000000000000000000011001
10101111110110010100111111111111111111111110001001
10100000010010110100110000000000001010011011100011
10101010010010100100011100111111001000000000100111
10111011010000000100000110000001101111100000101101
10100001111011000100110001101101001100111110100001
10111001001001001101110100101001001100000000101111
10000000011001101000010110101001001001111111100001
10100110001000101011010010101111001011000000101101
10100010000010101001010010000001101011000000000101
10111000100110101011010000011000101001011111111101
10001100110010001001000111001110100101010000000101
10100100010010101011001100000010110001010101011101
11110001011000101001011000110010111001010101000001
10000101001100101000011011111010101101010101011101
10101101000110001111001000110010100100010001001101
10111001100011100001001000010110110101111111101101
10010000110000111001011111010000000000000001101101
10011110110111111001011101010111001111111111001101
11110000000100000001000001010001111011000110011001
10000110000101111111111101010100000001110000000001
10010011100100100000000001000100111100011111111101
11111111111111111111111111111111111111111111111111